"filename", "language", "C++", "comment", "blank", "total"
"/home/manch1n/mylib/Channel.cc", "C++", 35, 2, 4, 41
"/home/manch1n/mylib/Channel.h", "C++", 40, 0, 10, 50
"/home/manch1n/mylib/EventLoop.cc", "C++", 70, 0, 8, 78
"/home/manch1n/mylib/EventLoop.h", "C++", 55, 0, 15, 70
"/home/manch1n/mylib/Latch.hpp", "C++", 26, 0, 3, 29
"/home/manch1n/mylib/Logger.cc", "C++", 72, 0, 9, 81
"/home/manch1n/mylib/Logger.h", "C++", 151, 5, 15, 171
"/home/manch1n/mylib/Observer.hpp", "C++", 51, 0, 11, 62
"/home/manch1n/mylib/Poller.cc", "C++", 49, 0, 9, 58
"/home/manch1n/mylib/Poller.h", "C++", 21, 0, 7, 28
"/home/manch1n/mylib/Singleton.hpp", "C++", 30, 0, 5, 35
"/home/manch1n/mylib/Thread.cc", "C++", 53, 0, 6, 59
"/home/manch1n/mylib/ThreadPool.h", "C++", 26, 0, 2, 28
"/home/manch1n/mylib/Timer.cc", "C++", 13, 0, 3, 16
"/home/manch1n/mylib/Timer.h", "C++", 24, 0, 6, 30
"/home/manch1n/mylib/TimerQueue.cc", "C++", 78, 0, 10, 88
"/home/manch1n/mylib/TimerQueue.h", "C++", 19, 0, 6, 25
"/home/manch1n/mylib/Timestamp.cc", "C++", 67, 0, 10, 77
"/home/manch1n/mylib/Timestamp.h", "C++", 25, 2, 5, 32
"/home/manch1n/mylib/test.cc", "C++", 65, 200, 6, 271
"Total", "-", 970, 209, 150, 1329